#11######
########4
332####44
##2#####4
#########
#########
#########
#########
#########